############################################
#++++++++++++++++++++++++++++++++++++++++++#
#+++++++++++++++++++++++++++++++++++++++++##
##++####################################++##
##++#**********************************#++##
##++#**********************************#++##
##++#*******############**************##++##
##++#*******#          #**************##++##
##++#*******#          #**************##++##
##++#*******#          #**************##++##
##++#*******#   ####   #**************##++##
##++#*******#   #  #   #******##########++##
##++#*******#   #  #   #******#*******##++##
##++#*******#   #  #   #******#*******##++##
##++#*******#   ####   #******#*******##++##
##++#*******#          ####***#*******##++##
##++#*******#######++######***#*******##++##
##++#**************++********#*******###++##
##++#**************##********###########++##
##++#*******########*********#********##++##
##++#*******#      #*********#********##++##
##++#*******#  ######*******############++##
##++#*******#        #****************##++##
##++#*******##########****************##++##
##++####################################++##
##++++++++++++++++++++++++++++++++++++++++##
##++++++++++++++++++++++++++++++++++++++++##
############################################
