############################################
#-------s----------------------------------#
#-//----s-------------------------------//##
##||####################################||##
##||#**********************************#||##
##||#**********************************#||##
##||#*******############**************##||##
##||#*******#          #**************##||##
##||#*******#          #**************##||##
##||#*******#          #**************##||##
##||#*******#   ####   #**************##||##
##||#*******#   #  #   #******##########||##
##||#*******#   #  #   #******#*******##||##
##||#*******#   #  #   #******#*******##||##
##||#*******#   ####   #******#*******##||##
##||#*******#          ####***#*******##||##
##||#*******#######||######***#*******##||##
##||#**************||********#*******###||##
##||#**************##********###########||##
##||#*******########*********#********##||##
##||#*******#      #*********#********##||##
##||#*******#  ######*******############||##
##||#*******#        #****************##||##
##||#*******##########****************##||##
##||####################################||##
##//------------------------------------//##
##//------------------------------------//##
############################################
